4
||||....................||||
|||......................|||
||........................||
|............E.............|
|..........................|
|..........................|
|..........................|
|..........................|
|..........................|
|..........................|
|..........................|
|............S.............|
|...____________________...|
|..........................|
|!!!!!!!!!!!!!!!!!!!!!!!!!!|